//--------------------------------------------------------------
//               (c)2004-2007 Aurora Team Presents:             
//                  ___                                         
//                 /   |_   _ _ __ ___  _ __ __ _               
//                / /| | | | | '__/ _ \| '__/ _` |              
//               / ___ | |_| | | | (_) | | | (_| |++            
//              /_/  |_|\____|_|  \___/|_|  \__,_|              
//                 http://aurora.deltaanime.net                 
//--------------------------------------------------------------
// Script Title: Izlude Battle Arena	Author: N/A
//--------------------------------------------------------------
// Revision History: vN/A
//--------------------------------------------------------------
//	N/A
//--------------------------------------------------------------
// Additional Notes: Script not yet started.
//--------------------------------------------------------------


